# Mapa grande (12x10) 
LL,BO,BO,BO,BO,BO,BO,BO,LL,LL,LL,LL
LL,AC,BO,BO,EN,EN,BO,LL,LL,LL,LL,LL
LL,AC,AC,BO,BO,BO,BO,LL,LL,LL,LL,LL
LL,LL,PA,PA,PA,BO,BO,LL,LL,LL,LL,LL
LL,LL,PA,EN,EN,BO,FO,BO,BO,LL,LL,LL
LL,LL,PA,PA,BO,BO,AC,AC,BO,BO,LL,LL
LL,LL,BO,BO,BO,BO,BO,AC,BO,BO,PA,PA
LL,BO,BO,AG,AG,BO,BO,BO,BO,BO,PA,PA
BO,AG,AG,AG,AG,BO,EN,EN,BO,BO,PA,PA
BO,AG,AG,AG,EN,EN,EN,BO,AR,BO,BO,PA
BO,BO,BO,BO,BO,BO,BO,AR,AR,AR,BO,BO

